ALL	AO L
BACK	B AE K
BEND	B EH N D
CLOSE	K L OW S
CLOSE(2)	K L OW Z
DOWN	D AW N
EXTENSION	IH K S T EH N SH AH N
GO	G OW
HAND	HH AE N D
HOME	HH OW M
LEFT	L EH F T
MOTORS	M OW T ER Z
MOVE	M UW V
OFF	AO F
POSITION	P AH Z IH SH AH N
RELEASE	R IY L IY S
RETRACT	R IY T R AE K T
RIGHT	R AY T
ROTATE	R OW T EY T
UP	AH P
